######################################################
#@.E#.....#.........#................................#
#.........#.........#................................#
#####.....#.........#................................#
#...................#................................#
#.........#######################..###################
#.........#........................#.................#
#.........#.......E................#..######.........#
#.........#..................##..###......##.........#
#.........#..................#.....#########.........#
#.........######.#####.......#.......................#
#.............#......#.......#.....#.......######....#
#############.#......#.......#.....#.......#....#....#
#.............#......#.......#.....#.......#....#....#
#...........#.########...#####.....#........E........#
#...........#............#...........................#
#...........#.#..........#...........................#
######################################################